7
#####
# @ #
# $ #
# . #
#####
