5
######
# .  #
# @  #
# $  #
######
