10 20 30 40 41 31 21 11
  ####
  #  #
  #$ #
  #  # ####
### ####  #
#  .. ..  ###
# $*. *.$@  #
## #$ $#$ # #
 # #   #  # #
 #  ######  #
 ##        ##
  ##########