5
######
# .  #
# $  #
# @  #
######
