5
######
#    #
# $  #
# @  #
######
