2
#######
# @   #
#     #
#  $  #
#     #
#   . #
#######
