4
#######
# @   #
# # # #
# $   #
#   . #
#######
