6
######
#@ $ #
#### #
#   .#
######
